48,64
9999999999999999999999999999999999999999999999999999999999999999
9000000000000000000000000000000000000000000000000000000000000009
9000000000000000000000000000000000000000000000000033000000000009
9000000000000000000000000000000000000000000000000033000000000009
9000000000000000000000000000008000000000000000000033000000000009
9000000000000000000000000000000000000000000000000033000000000009
9000000000000000000000000000000000000000000000000033000000000009
9000000000000000000000000000000000000000000000000000000000000009
9000000000000000030000000000000000060000000000000000000000000009
9000000000000000030000000000000000000000000000000000000000000009
9000000000000000030000000000000000000000000000000000000000000009
9000000007000000030000000000000000000000000000000000000000000009
9000000000000000030000000000000000000000000000000000000000000009
9000000000000000030000000000000000000000000000000000000000000009
9000000000000000030000000000000000000000000000000000000000000009
9000000000000000030000000000000000000000000000000000000000000009
9000000000000000030000000000000000000000000000000000000000000009
9000000000000000033333333344444000000000000000000000000000000009
9000000000000000000000000000004000000000000000000000000000000009
9000000000000000000000000000004000000000000000000000000000000009
9000000000000000000002222222004002222222000000000000000000000009
9000000000000000000002222222004002222222000000000000000000000009
9000000000000000000002226222004002226222000000000000000000000009
9000000000000000000002222222004002222222000000000000000000000009
9000000000000000000002222222004002222222000000000000000000000009
9000000000000000000000000000004000000000000000000000000000000009
9000000000000000000000000000004000000000000000000000000000000009
9000000000000000000000000000004444333333333000000000000000000009
9000000000000000000000000000000000000000003000000000000000000009
9000000000000000000000000000000000000000003000000000000000000009
9000000000000000000000000000000000000000003000000000000000000009
9000000000000000000000000000000000000000003000000000000000000009
9000000000000010000000000000000000000000003000000000000000000009
9000000000000000000000000000000000000000003000000000000000000009
9000000000000000000000000000000000000000003000000000000000000009
9000000000000000000000000000000000000000003000000000070000000009
9000000000000000000000000000000000000000003000000000000000000009
9000000000000000000000000000000000000000003000000000000000000009
9000000000000000000000000000000000000000003000000000000000000009
9000000000000010000000000000000000000000000000000000000000000009
9000000000000000000000000000000000000000000000000000000000000009
9000000000033000000000000000000000000000000000000000000000000009
9000000000033000000000000000000000000000000000000000000000000009
9000000000033000000000000000008000000000000000000000000000000009
9000000000033000000000000000000000000000000000000000000000000009
9000000000033000000000000000000000000000000000000000000000000009
9000000000000000000000000000000000000000000000000000000000000009
9999999999999999999999999999999999999999999999999999999999999999