48,64
999999999999999999999999999999999999999999999999
900003300000000000000000000000000000000000000009
900003300800000000000000000000000000000000000009
900003300000000000000000000000000000000000000009
900003300000000000000000000000000000000000000009
900003300000000000000000000000000000000000000009
900003300000000000000000000000000000000000000009
900003300000000000000000000000000000000000000009
900000000000000000000000000000000000000000000009
900000000000000000000000000000000000000000000009
900000000000000030000000000000000000000000000009
900000000000000030000000000000000000000000000009
900000000000000030000000000000000000000000000009
900000000000000030000000000000000000000000000009
900000000000000030000000000000000000000000000009
900000000000000030000000000000000000000000000009
900000000000000030000000000000000000030000000009
900000000000000030000000000000000070030000000009
900000000000000030000000000000000000030000000009
900000000000000000000000000000000000030000000009
900000000000000000000000000000000000030000000009
900000000000000000000000000000000000030000000009
900000000000000000000000000000000000030000000009
900000000000000000000000000333333300030000000009
900000000000000000000000000333333300030000000009
900000000000000222000000000333333300030000000009
900333330000000262000004000333133300030000000009
900000000000000222000004000333333300030000000009
900000000000000000000004000333333300030000000009
900000000000000000000004000333333300030000000009
900000000000000000000004000000000000030000000009
900000000333333333334444444333333333330000000009
900000000300000000000004000000000000000000000009
900000000300033333330004000000000000000000000009
900000000300033333330004000000000000000000000009
900000000300033333330004000002220000000000000009
900000000300033313330004000002620000000033333009
900000000300033333330000000002220000000000000009
900000000300033333330000000000000000000000000009
900000000300033333330000000000000000000000000009
900000000300000000000000000000000000000000000009
900000000300000000000000000000000000000000000009
900000000300000000000000000000000000000000000009
900000000300000000000000000000000000000000000009
900000000300000000000000000000300000000000000009
900000000300700000000000000000300000000000000009
900000000300000000000000000000300000000000000009
900000000000000000000000000000300000000000000009
900000000000000000000000000000300000000000000009
900000000000000000000000000000300000000000000009
900000000000000000000000000000300000000000000009
900000000000000000000000000000300000000000000009
900000000000000000000000000000300000000000000009
900000000000000000000000000000000000000000000009
900000000000000000000000000000000000000000000009
900000000000000000000000000000000000000000000009
900000000000000000000000000000000000000003300009
900000000000000000000000000000000000000003300009
900000000000000000000000000000000000000003300009
900000000000000000000000000000000000000003300009
900000000000000000000000000000000000000003300009
900000000000000000000000000000000000008003300009
900000000000000000000000000000000000000003300009
999999999999999999999999999999999999999999999999