[29,15]
999999999999999
900000000000009
900000000003009
908000000003009
900000070003009
900300000003009
900300000003009
900300000000009
900333330000009
900000030000009
900000040000009
900000040000009
900000242000009
900002646200009
900000242000009
900000040000009
900000040000009
900000030000009
900000033333009
900000000003009
900000000003009
900000000003009
900300000000009
900300000000009
900300070000009
900300000000809
900300000000009
900000000000009
999999999999999